###########x##########
#....................#
#.####....#.##..####.#
#.#G......#....#...#.#
#.#..###..#....#.#.#.#
#.#..###..#..#.#.#.#.#
#.........#..#.#.#...#
#.#.#........#.#.#.#.#
#.#.#.###..#.#...#.#.#
#.#........#.#.....#.#
#....#..#.@..#..#..#.#
#.#..#..#....#..#....#
#.#.....#.#........#.#
#.#.#...#.#..###.#.#.#
#.#.#.#.#........#.#.#
#...#.#.#..#.........#
#.#.#.#.#..#..###..#.#
#.#.#.#....#..###..#.#
#.#...#....#.......#G#
#.####..####....####.#
#.........#..........#
###########Q##########
