###########x##########
#.........#.#........#
#.####....#.##..####.#
#.#G......#....#..G#.#
#.#..###..#....#.#.#.#
#.#..###..#..#.#.#.#.#
#.........#..#.#.#...#
#.#.#........#.#.#.#.#
#.#.#.###..#.#...#.#.#
#.#........#.#.....#.#
#....#..#.@..#..#..#.#
#.#..#..#....#..#....#
#.#.....#.#........#.#
#.#.#...#.#..###.#.#.#
#.#.#.#.#........#.#.#
#...#.#.#..#.........#
#.#.#.#.#..#..###..#.#
#.#.#.#....#..###..#.#
#.#...#....#.......#.#
#.####..####....####.#
#.........#..........#
###########x##########
