######################
#....................#
#.####....#G##..####.#
#.#.......#....#...#.#
#.#..###..#....#.#.#.#
#.#..###..#..#.#.#.#.#
#.........#..# #.#...#
#.#.#........#.#.#.#.#
#.#.#.###..#.#...#.#.#
#.#........#.#.....#.#
#....#..#.@..#..#..###
#.#..#..#....#..#....x
#.#.....#.#........###
#.#.#...#.#..###.#.#.#
#.#.#.#.#........#.#.#
#...#.#.#..#.........#
#.#.#.#.#..#..###..#.#
#.#.#.#....#..###..#.#
#.#G..#....#.......#.#
#.####..##......####.#
#.........#.#........#
###########x##########
