######################
#....................#
#.####....#.##..####.#
#.#.......#....#...#.#
#.#..###..#....#.#.#.#
#.#..###..#..#.#G#.#.#
#.........#..#.#.#...#
#.#.#........#.#.#.#.#
#.#.#.###..#.#...#.#.#
#.#........#.#.....#.#
##...#..#.@..#..#..#.#
x....#..#....#..#....#
#.#.....#.#........#.#
#.#.#...#.#..###.#.#.#
#.#.#.#.#........#.#.#
#...#.#.#..#.........#
#.#.#.#.#..#..###..#.#
#.#.#.#....#..###..#.#
#.#G..#....#.......#.#
#.####..##.##...####.#
#...........#........#
###########x##########
