######################
#....................#
#.####....#.##..####.#
#.#.......#....#G..#.#
#.#..###..#....#.#.#.#
#.#..###..#..#.#.#.#.#
#.........#..#.#.#...#
#.#.#........#.#.#.#.#
#.#.#.###..#.#...#.#.#
#.#........#.#.....#.#
#....#..#....#..#..#.#
#.#..#..#@...#..#....x
#.#.....#.#........###
#.#.#...#.#..###.#.#.#
#.#.#.#.#........#.#.#
#...#.#.#..#.........#
#.#.#.#.#..#..###..#.#
#.#.#.#....#..###..#.#
#.#...#....#.......#.#
#.####..####....####.#
#.........#..........#
###########x##########
