###########x##########
#...........#........#
#.####....#.##..####.#
#.#.......#....#...#.#
#.#..###..#....#.#.#.#
#.#..###..#..#.#.#.#.#
#.........#..#.#.#...#
#.#.#........#.#.#.#.#
#.#.#.###..#.#...#.#.#
#.#........#.#.....#.#
#....#..#.@..#..#..###
#.#..#..#....#..#....x
#.#.....#.#........###
#.#.#...#.#..###.#.#.#
#.#.#.#.#........#.#.#
#...#.#.#..#.........#
#.#.#.#.#..#..###..#.#
#.#.#.#....#..###..#.#
#.#...#....#.......#.#
#.####..##.#G...####.#
#...........#........#
###########x##########
