######################
#. .............. ...#
#.####. ..#.##..####.#
#.# ......#. ..#...#.#
#.#..###..#....#.#.#.#
#.#..###..#..#.#.#.#.#
#.........#..#.#.#...#
#.#G#........#.#.#.#.#
#.#.#.###..#.#...#.#.#
#.#........#.#.....#.#
#....#..#.@..#..#..#.#
#.#..#..#....#..#....x
#.#.....#.#........###
#.#.#. .#.#..### #.#G#
#.#.#.#.#...... .#.#.#
#...#.#G#..#.........#
#.#.#.#.#..#..###..#.#
#.#.#.#....#..###..#.#
#.#...#....#.......#.#
#.####..##.#....####.#
# ... ............ ..#
######################
