###########x##########
#...........#........#
#.####....#.##..####.#
#.#.......#....#..G#.#
#.#..###..#....#.#.#.#
#.#..###..#..#.#.#.#.#
#.........#..#.#.#...#
#.#.#........#.#.#.#.#
#.#.#.###..#.#...#.#.#
#.#........#.#.....#.#
#....#..#.@..#..#..#.#
#.#..#..#....#..#....#
#.#.....#.#........#.#
#.#.#G..#.#..###.#.#.#
#.#.#.#.#........#.#.#
#...#.#.#..#.........#
#.#.#.#.#..#..###..#.#
#.#.#.#....#..###..#.#
#.#...#....#.......#.#
#.####..####....####.#
#.........#..........#
###########x##########
