######################
#G...................#
# ####....#.## .####.#
#.#.......#....#...#.#
#.#..###..#....#.#.#.#
#.#..###..#..#.#.#.#.#
#.........#..#.#.#...#
#.#.#........#.#.#.#.#
#.#.#.###..#.#..##.#.#
#.#........#.#..#..#.#
###..#..#.@..#..#..###
x.#..#..#....#..#....x
#.#.....#.#..... ..###
#.#.#...#.#..###.# #.#
#.#.#.#.#........#.#.#
#.. #.#.#..#.....#...#
#.#.#.#.#..#..###..#.#
#.#.#.#....#..###..#.#
#.#..G#....#.......#.#
#.####..##.#....####.#
#....................#
######################
