###########x##########
#...........#........#
#.####....#.##..####.#
#.#.......#....#...#.#
#.#..###..#....#.#.#.#
#.#..###..#..#.#.#.#.#
#.........#..#.#.#...#
#.#.#........#.#.#.#.#
#.#.#.###..#.#...#.#.#
#.#........#.#.....#.#
#....#..#.@..#..#..#.#
#.#..#..#....#..#....#
#.#.....#.#........#.#
#.#.#...#.#..###.#.#G#
#.#.#.#.#........#.#.#
#...#.#.#..#.........#
#.#.#.#.#..#..###..#.#
#.#.#.#....#..###..#.#
#.#G..#....#.......#.#
#.####..##.#....####.#
#....................#
######################
