######################
#....................#
#.####....#.##..####.#
#.#.......#....#...#.#
#.#..###..#....#.#.#.#
#.#..###..#..#.#.#.#.#
#.........#..#.#.#...#
#.#.#........#.#.#.#.#
#.#.#G###..#.#...#.#.#
#.#........#.#.....#.#
##...#..#.@..#..#..#.#
x....#..#....#..#....#
###.....#.#........#.#
#.#.#...#.#..###.#.#.#
#.#.#.#.#........#.#.#
#...#.#.#..#.........#
#.#.#.#.#..#..###..#.#
#.#.#.#....#..###..#.#
#.#...#............#.#
#.####G.##......####.#
#.........#.#........#
###########x##########
